{
  "DEMO-TC-0001": "55555555-5555-4000-8000-555555555001",
  "DEMO-TC-0002": "55555555-0000-4000-8000-000000000002",
  "DEMO-TC-0003": "55555555-0000-4000-8000-000000000003",
  "DEMO-TC-0004": "55555555-0000-4000-8000-000000000004",
  "DEMO-TC-0005": "55555555-0000-4000-8000-000000000005",
  "DEMO-TC-0006": "55555555-0000-4000-8000-000000000006"
}
